icon_add	icon_plus
icon_add_circle	icon_plus_circle
icon_aeb	icon_car_front_upside_wave2_reversed_up
icon_ai	icon_sparkle2
icon_android_share	icon_androidshare
icon_arrow	icon_arrow_up_right
icon_arrow_downward	icon_arrow_down
icon_arrow_drop_down	icon_triangle_down_small
icon_arrow_drop_up	icon_triangle_up_small
icon_arrow_upward	icon_arrow_up
icon_article	icon_article
icon_backward	icon_arrow_left
icon_bill	icon_receipt
icon_bold	
icon_bookmark	icon_bookmark
icon_bookmark_list	icon_horizline3_vertical_star
icon_calendar	icon_calendar
icon_call	icon_phone
icon_call_declined	icon_phone_xmark
icon_camera	icon_camera
icon_car	icon_car_frontside
icon_car_around_view	icon_arrow_clockwise_oval
icon_car_blind_spot	icon_car_rear_upside_wave2_reversed_down_left
icon_car_cruise_control	icon_speedometer
icon_car_epb	icon_epb
icon_car_heated_seat	icon_seat_left_heatwave2
icon_car_heated_steering_wheel	icon_steeringwheel_heatwave2
icon_car_ldws	icon_roadlane
icon_car_leather_seat	icon_seat_left
icon_car_navigation	icon_compass
icon_car_power_trunk	icon_car_rear_trunk_open_leftside
icon_car_rear_camera	icon_car_rear_upside_sector_down
icon_car_rear_sensor	icon_car_rear_upside_wave2_reversed_down
icon_car_smart_key	icon_smartkey
icon_car_ventilation_seat	icon_seat_left_fan
icon_cart	icon_cart
icon_certification	icon_crosshair
icon_challenge	icon_flag_hill
icon_chart	icon_barchart_square
icon_chat_bubble_check	icon_checkmark_chatbubble_left
icon_chatting	icon_dot3_horizontal_chatbubble_left
icon_chatting_send	icon_paperplane
icon_check	icon_checkmark
icon_check_flower	icon_checkmark_flower
icon_chevron_left	icon_chevron_left
icon_chevron_right	icon_chevron_right
icon_click	icon_hand_point_up
icon_clock	icon_clock
icon_close	icon_xmark
icon_cobuying	
icon_community	icon_post
icon_condo	icon_building2
icon_confirmation	icon_checkmark_shield
icon_confirmation_pay	icon_won_shield
icon_confirmation_profile	icon_person_shield
icon_contents	icon_grid_heart
icon_convert	icon_arrow_right_arrow_left
icon_copy	icon_square2_stacked
icon_coupon	icon_coupon
icon_coupon_download_done	icon_checkmark_horizline
icon_coupon_used	icon_checkmark_coupon
icon_delete_keyboard	icon_backspacekey
icon_delivery	
icon_direction	icon_arrow_right_angled
icon_download	icon_arrow_down_horizline
icon_edit	icon_eraser_horizline
icon_emoticon	icon_face_smile_circle
icon_emoticon_bad	icon_face_sad_circle
icon_expand	icon_arrow_up_right_arrow_down_left
icon_expand_less	icon_chevron_up
icon_expand_more	icon_chevron_down
icon_file	icon_paperclip
icon_filter02	icon_slider2_horizontal
icon_forward	icon_arrow_right
icon_gender	icon_malesymbol_femalesymbol
icon_global	icon_globe
icon_gps	icon_crosshair
icon_gps_enable	icon_crosshair_questionmark
icon_gps_enable2	icon_crosshair_questionmark
icon_groupchat_king	icon_crown
icon_handle	icon_horizline3_vertical_tight
icon_hashtag	icon_hash
icon_headphone	icon_headset
icon_heart	icon_heart
icon_help	icon_questionmark_circle
icon_helpcenter	icon_headset
icon_helper	icon_headset
icon_home	icon_house
icon_house	icon_window4_house
icon_housekeeping_book	icon_book
icon_import	icon_document_arrow_left
icon_info	icon_i_lowercase_serif_circle
icon_interest	icon_horizline3_vertical_star
icon_interest_list	icon_star
icon_invite	icon_envelope
icon_invite_friend	icon_person_plus
icon_ios_share	icon_arrow_up_bracket_down
icon_jobs	icon_person_magnifyingglass
icon_keyboard_hiding	icon_keyboard_chevron_down
icon_keyword	icon_tag
icon_laptop	icon_laptop
icon_leaf	icon_leaf
icon_list	icon_dothorizline3_vertical
icon_list_card	icon_horizrectangle_horizline2_vertical
icon_list_check	icon_document_checkmark
icon_list_select	icon_horizline3_vertical_checkmark
icon_list_thumbnail	icon_squareline2_vertical
icon_location	icon_locationpin
icon_lock	icon_lock
icon_loudspeaker	icon_megaphone
icon_map	icon_map_locationpin
icon_market	icon_store
icon_market_check	icon_store_checkmark
icon_market_write	icon_store_pen
icon_mention	icon_at
icon_menu	icon_horizline3_vertical
icon_mic	icon_microphone
icon_mic_off	icon_microphone_slash
icon_mission	icon_book_open
icon_mobile	icon_mobile
icon_money_send	icon_won_circle_arrow_right
icon_money_won	icon_won_circle
icon_moon	icon_moon
icon_more_horiz	icon_dot3_horizontal
icon_more_vert	icon_dot3_vertical
icon_my	icon_person
icon_my_profile	icon_person_circle
icon_near_me	icon_locationpin
icon_newtopic	icon_n_uppercase_circle
icon_note	icon_document
icon_notification	icon_bell
icon_notification_fall	icon_arrow_down
icon_notification_off	icon_bell_slash
icon_order	icon_checkmark_clipboard
icon_pause	icon_vertrectangle2_horizontal
icon_payment	icon_card
icon_percent	icon_percent
icon_photo	icon_picture
icon_photo_edit	icon_wand
icon_photo_edit_crop	icon_cropmark
icon_photo_edit_draw	icon_scribble
icon_photo_edit_rotate	icon_arrow2_clockwise_circular
icon_photo_several	icon_picture2_stacked
icon_play	icon_triangle_right
icon_poll	icon_barchart_square
icon_price_won	icon_won
icon_product	icon_shoppingbag
icon_profile	icon_person
icon_profile_badge	icon_checkmark_badge
icon_prohibition	icon_slash_circle
icon_pushpin	icon_pushpin
icon_question_check	icon_questionmark_square
icon_redo	icon_arrow_uturn_right
icon_refund	icon_won_arrow_clockwise_circular
icon_remove_circle	icon_xmark_circle
icon_reply	icon_horizline2_vertical_chatbubble_right
icon_reply_mission	icon_horizline2_vertical_chatbubble_right
icon_reply_re	icon_corner_down_left
icon_report	icon_flag
icon_reservation	icon_checkmark_calendar
icon_restaurant	icon_fork_spoon
icon_retry	icon_arrow_clockwise_circular
icon_review_star	icon_star
icon_scanner	icon_horizline_viewfinder
icon_search	icon_magnifyingglass
icon_search_doc	icon_document_magnifyingglass
icon_sell	icon_plus_square
icon_setting	icon_gear
icon_signout	icon_bracket_left_arrow_right
icon_sort	icon_arrow_up_arrow_down
icon_story	icon_triangle_right_chatbubble_left
icon_story_article	icon_document_pen
icon_subtract_circle	icon_minus_circle
icon_subtraction	icon_minus
icon_suggest	
icon_sun	icon_sun
icon_talkingdown	icon_quotationmark2_right
icon_talkingup	icon_quotationmark2_left
icon_text	icon_t_uppercase_serif
icon_thumb_down	icon_thumb_down
icon_thumb_up	icon_thumb_up
icon_toolbox	icon_toolbox
icon_translate	icon_translation
icon_trash	icon_trashcan
icon_undo	icon_arrow_uturn_left
icon_user_group	icon_person2
icon_video	icon_camcorder
icon_view_count	icon_eye
icon_view_count_off	icon_eye_slash
icon_volume_off	icon_speaker_slash
icon_volume_on	icon_speaker_wave2
icon_vote	icon_checkmark_ballotbox
icon_voucher	icon_gift
icon_walk	icon_figure_walk
icon_warning	icon_exclamationmark_circle
icon_write	icon_pen_horizline
icon_write_frequent_use	icon_document_plus
icon_write_story	
